fortunately = на щастя = I was late, but fortunately the meeting hadn't started
thought = думка / роздум = My first thought was that something must have changed
customer = покупець / клієнт = They are our potential customers
overcome = подолати = Molly had fought and overcome her fear of flying
shelf = полиця = She removed the book from the shelf and opened it to the dedication page
sudden = раптовий / несподіваний = His death was very sudden
treasure = скарб / коштовність = The house was large and full of art treasures
withdraw = вилучати / знімати = She withdrew $200 from her checking account
accidentally = випадково = I accidentally deleted the file
beside = поруч / крім того = The man beside her was wearing a brown suit and hat
courageously = сміливо / мужньо = He has battled courageously on his constituents' behalf
justice = справедливість = He only wants freedom, justice and equality
masterpiece = шедевр = His masterpiece is a collection of short stories, called The Spinning Room
plate = тарілка = She carried her plate to the sink
supplier = постачальник = They used to be a leading supplier of military equipment
incredibly = неймовірно = He looked incredibly sad
purse = гаманець = Grabbing her purse, she ran out the door
performance = продуктивність / представлення = Her performance in the play was great
fame = слава / популярність = The book tells the story of her sudden rise to fame
fortune = доля / багатство / статок = He made his fortune in car sales
high-quality / low-quality = високоякісний / низькоякісний = Laser printers give high quality print
recognition = визнання = He finally received recognition from his boss
curtains = штори = Could you please pull the curtain aside?
hook = гачок = Hang your towel on a hook
impolitely = неввічливо = He impolitely asked whether she had been wearing the same clothes for three days straight
remark = зауваження = His remark about how she looked in the swimsuit made it obvious that he saw her as something more than a baby sitter or maid
celebrity = знаменитість / видатна людина = He became a national celebrity
definitely = безумовно = She definitely didn't expect the decision to be so hard
ancient = давній = It looked ancient, and he opened it carefully
constant = постійний = The house is in constant need of repairs
instead of = замість (prep) = I will try to make friends instead of enemies
point out = вказати / зазначити = He pointed out the dangers of driving alone
